...............
........###....
..#########....
..#.....###....
..#......#.....
..#..#########.
..############.
.....#########.
.......#...#...
.......#####...
.......#...#...
.###..#######..
.#@##########..
.###..#######..
...............