--...+.........
--&..+../^%.-..
..|~~*~~#!)..+.
.._&.+.."#=&&..
&.*..--..*---..
.._..|}^^#^^}{.
..[~~$$#####$;&
..&..[:#,,,#:].
.+..+..*.--*...p
.-.&&..?***;...
.--.&..*-..*.+.
./^%../#}}}#%..
.(@#~~##$*$#)..
.",=&-",:::,=.-
+...&&...+...--