-.........--...
.|}{..|}{..|}{.
.?$#**#$#**#$;.
.[#=.-"#=.."#].
..*....*..+.*--
..*.+..*....*..
.|#%../#%-./#{.
.?$#**#!#**#$;.
.[#=.."#=.."#].
..*.+..*.-..*..
..*....*....*..
./#%../#%../#{.
.(@#**#$#**#$;.
.",=..[:]..[:].
.-......++.....